XXXXXXXXXXXXXXXXXXXXXXXXXXXX
xGGG  s     R    S   E  SOCx
x    wwwwwwwwwwwwwwwwww    x
x    w RH     Cw         wGx
x  E  w   wwwwww     E   wGx
x  C    w  w    w    wwwwwGx
x G   w  o   E   R     P wGx
x G   w    www  H   S    wGx
x G   w  S  wc       E   w x
x    w  E  www  wwwwwww  w x
x E   w     C           ww x
x    w    w  C G    w E w  x
x    w    wwwwwwwww     w Hx
X    w   O      E    wwwwwwx
x c S     H   C            
XXXXXXXXXXXXXXXXXXXXXAXXXXXX