XXXXXXXXXXXXXXXXXXXX
X                  X
X              H   X
X     E            X
X                  X
X              E   X
X    H             X
X                  X
X    E             X
X                  X
X                  X
X       H        P X
X                  X
XXXXXXXXXXXXXXXXXXXX