XXXXXXXXXXXXXXXXXXXX
X                  X
X                  X
X     E            X
X                  X
X              E   X
X                  X
X                  X
X    E             X
X                  X
X                  X
X               P  X
X                  X
XXXXXXXXXXXXXXXXXXXX