XXXXXXXXXXXXXXXXXXXXXXXXXXXX
xGGG  s     R       E   SOCx
x    wwwwwwwwwwwwwwwwww    x
x    w RH     Cw     C   wGx
x  E  w   wwwwww     E   wGx
x  C    w  w    w    wwwwwGx
x G   w  o   E   R     P wGx
x G   w  C  www  H       wGx
x G   w    wc       E    w x
x    w  E  www  wwwwwww  w x
x E   w     C           ww x
x    w    w  C G    w E w  x
x    w    wwwwwwwww     w Hx
X    w   O      E      wwwwx
x c S     H   C        A       
XXXXXXXXXXXXXXXXXXXXXXXXXXXX