XXXXXXXXXXXXXXXXXXXXXXXXXXXX
xGGG  s     R             Cx
x    wwwwwwwwwwwwwwwwww    x
x    w RH     Cw         wGx
x  E  w   wwwwww     E   wGx
x      w  w    w    wwww wGx
x G   w     E   R      P wGx
x G   w    www  H        wGx
x G   w    wc            w x
x    w    www  wwwwwww   w x
x E   w                 ww x
x    w    w  C G    w E w  x
x    w    wwwwwwwww     w Hx
X    w                 wwwwx
x c     H            A       
XXXXXXXXXXXXXXXXXXXXXXXXXXXX