XXXXXXXXXXXXXXXXXXXX
x   wwwwwwwwwwwww  x
x           c  Hw  x
x     E         w  x
x   wwwwwwwwwwwww  x
x              E   x
x    H             x
x                  x
x    E        c    x
x                  x
x                  x
x       H        P x
x                  x
XXXXXXXXXXXXXXXXXXXX